.acr "!unitlist" %user% typed `!unitlist`. This contains a picture of all units and common abbreviations.

__**Diagram of All Units**__

<http://bit.ly/efunitpicture> - A great diagram by a reddit user.

__**Common Abbreviations (Updated 24/04/2017)**__

```
Alch    - Alchemist
BF      - Big Foot
BM      - Blade Master
BMW     - Black Magic Wizard
CK      - Cavalry Knight
Cle     - Cleric
DA      - Dark Archer
DAd     - Dark Admiral
DW      - Dark Elf
DS      - Dark Spirit
EA      - Elf Archer
Ele     - Elementalist
EW      - Elf Warrior
FD      - Frost Demon
FG      - Forest Guardian
FB      - Fire Bird
FM      - Fire Mage
Frost   - Frost Mage
FS      - Fire Spirit
Ghost   - Ghost
GE      - Green Eagle
GH/GHU  - Great Hammer Unit
Goku    - Hoyden Goku
GR      - Griffin Rider
HB/HBX  - Hot-Blooded Xuanzang
HEA     - High Elf Archer
HI      - Heavy Infantry
HG      - Hippogriff
HK      - Hammer Knight
HoD     - Hands of Death
Inc     - Incubus
Inf     - Infantry
IS      - Ice Spirit
IW      - Ice Wizard
Med/Mom - Medusa
Musk    - Musketeer
Naga    - Naga
NoD     - Dark Ninja
OA      - Orc Ax Unit
OF      - Orc Fighter
OH      - Orc Hunter
OHU     - Orc Hammer Unit
OW      - Orc Wing
PA      - Poison Archer
RR      - Raptor Rider
SD      - Sword Dancer
SP      - Steam Punk
SU      - Skeleton Unit
SW      - Skeleton Warrior
Sylph   - Sylphid
UK      - Unicorn Knight
Valk    - Valkyrie
Lock    - Warlock
WM      - Wind Mage
WR      - Wolf Rider
WW      - Wolf Warrior
Wyvern  - Wyvern Rider
```